{
    "data": {
        "0": {
            "map": [
                [0,  0,  0,  0,  0,  0,  0,  0,  0,  0,  0,  0,  0,  0,  0,  0,  0,  0,  0,  0,  0,  0,  0,  0,  0,  0,  0,  0,  0,  0,  0],
                [0,  0,  0,  0,  0,  0,  0,  0,  0,  0,  0,  0,  0,  0,  0,  0,  0,  0,  0,  0,  0,  0,  0,  0,  0,  0,  0,  0,  0,  0,  0],
                [0,  0,  0,  0,  0,  0,  0,  0,  0,  0,  0,  0,  0,  0,  0,  0,  0,  0,  0,  0,  0,  0,  0,  0,  0,  0,  0,  0,  0,  0,  0],
                [0,  0,  0,  0,  0,  0,  0,  0,  0,  0,  0,  0,  0,  0,  0,  0,  0,  0,  0,  0,  0,  0,  0,  0,  0,  0,  0,  0,  0,  0,  0],
                [0,  0,  0,  0,  0,  0,  0,  0,  0,  0,  0,  0,  0,  0,  0,  0,  0,  0,  0,  0,  0,  0,  0,  0,  0,  0,  0,  0,  0,  0,  0],
                [0,  0,  0,  0,  0,  0,  0,  0,  0,  0,  0,  0,  0,  0,  0, -1,  0,  0,  0,  0,  0,  0,  0,  0,  0,  0,  0,  0,  0,  0,  0],
                [0,  0,  0,  0,  0,  0,  0,  0,  0,  0,  0,  0,  0,  0,  0,  0,  0,  0,  0,  0,  0,  0,  0,  0,  0,  0,  0,  0,  0,  0,  0],
                [0,  0,  0,  0,  0,  0,  0,  0,  0,  0,  0,  0,  0,  0,  0,  0,  0,  0,  0,  0,  0,  0,  0,  0,  0,  0,  0,  0,  0,  0,  0],
                [0,  0,  0,  0,  0,  0,  0,  0,  0,  0,  0,  0,  0,  0,  0,  0,  0,  0,  0,  0,  0,  0,  0,  0,  0,  0,  0,  0,  0,  0,  0],
                [0,  0,  0,  0,  0,  0,  0,  0,  0,  0,  0, -2,  0,  0,  0,  0,  0,  0,  0,  0,  0,  0,  0,  0,  0,  0,  0,  0,  0,  0,  0],
                [0,  0,  0,  0,  0,  0,  0, -2,  0, -2,  1,  2,  2,  2,  3,  0,  0,  0,  0,  0,  0,  0,  0,  0,  0, -2,  0,  1,  3,  0,  0],
                [0,  0, -2,  0,  0,  0, -2,  1,  2,  2, 16,  6,  6,  6, 17,  2,  2,  2,  3, -2,  0, -2,  0,  0, -2,  1,  2, 16,  7,  0,  0],
                [0,  0,  4,  0,  0,  0,  1, 16,  6,  6,  6,  6,  6,  6,  6,  6,  6,  6, 17,  2,  2,  3,  0,  0,  1, 16,  6,  6,  7,  0,  0],
                [0,  0,  8,  0,  0,  0,  5,  6,  6,  6,  6,  6,  6,  6,  6,  6,  6,  6,  6,  6,  6, 17,  2,  2, 16,  6,  6,  6,  7,  0,  0],
                [0,  0,  8,  0,  0,  0,  5,  6,  6,  6,  6,  6,  6,  6,  6,  6,  6,  6,  6,  6,  6,  6,  6,  6, 19, 10, 10, 10, 11,  0,  0],
                [0,  0,  8,  0,  0,  0,  5,  6,  6,  6,  6,  6,  6,  6,  6,  6,  6,  6,  6, 19, 10, 10, 10, 10, 11,  0,  0,  0,  0,  0,  0],
                [0,  0, 12,  0,  0,  0,  9, 18,  6,  6,  6,  6,  6,  6,  6,  6,  6,  6, 19,  7,  0,  0,  0,  0,  0,  0,  0,  0,  4,  0,  0],
                [0,  0,  0,  0,  0, -2,  0,  9, 10, 10, 10, 10, 10, 10, 18, 19, 10, 10, 11,  0,  0,  0,  0,  0,  0,  0,  0,  0, 12,  0,  0],
                [0,  0,  0,  0,  0,  4,  0,  0,  0,  0,  0,  0,  0,  0,  5,  7,  0,  0,  0,  0,  0,  0,  0, -2, -2, -2,  0,  0,  0,  0,  0],
                [0,  0,  0,  0,  0,  8,  0,  0,  0,  0,  0, -2, -2,  0,  5,  7,  0,  0,  0,  0,  0,  0, 13, 14, 14, 15,  0,  0,  0,  0,  0],
                [0,  0,  0,  0,  0,  8,  0,  0, -2,  0, -2,  1,  2,  2, 16,  7,  0, -2, -2,  0,  0,  0,  0,  0,  0,  0,  0,  0,  0,  0,  0],
                [0,  0,  0,  0,  0,  8,  0,  0,  1,  2,  2, 16,  6,  6,  6, 17,  2,  2,  3,  0,  0,  0,  0,  0,  0,  0,  0,  0,  0,  0,  0],
                [0,  0,  0,  0,  0, 12,  0,  0,  5,  6,  6,  6,  6,  6,  6,  6,  6,  6,  7,  0,  0,  0,  0,  0,  0,  0,  0,  0,  0,  0,  0],
                [0,  0,  0,  0,  0,  0,  0,  0,  9, 18,  6,  6,  6,  6,  6, 19, 10, 10, 11,  0,  0,  0,  0,  0,  0,  0,  0,  0,  0,  0,  0],
                [0,  0,  0,  0, -2,  0, -2,  0,  0,  5,  6,  6,  6,  6,  6,  7,  0,  0,  0,  0,  0,  0,  0,  0,  0,  0,  0,  0,  0,  0,  0],
                [0,  0,  0, 13, 14, 14, 15,  0,  0,  9, 10, 10, 10, 10, 10, 11,  0,  0,  0,  0, -2,  0,  0,  0,  0,  0,  0,  0,  0,  0,  0],
                [0,  0,  0,  0,  0,  0,  0,  0,  0,  0,  0,  0,  0,  0,  0,  0,  0,  0,  0, 13, 14, 14, 14, 15,  0,  0,  0,  0,  0,  0,  0],
                [0,  0,  0,  0,  0,  0,  0,  0,  0,  0,  0,  0,  0,  0,  0,  0,  0,  0,  0,  0,  0,  0,  0,  0,  0,  0,  0,  0,  0,  0,  0],
                [0,  0,  0,  0,  0,  0,  0,  0,  0, 13, 14, 14, 14, 14, 14, 14, 15,  0,  0,  0,  0,  0,  0,  0,  0,  0,  0,  0,  0,  0,  0],
                [0,  0,  0,  0,  0,  0,  0,  0,  0,  0,  0,  0,  0,  0,  0,  0,  0,  0,  0,  0,  0,  0,  0,  0,  0,  0,  0,  0,  0,  0,  0],
                [0,  0,  0,  0,  0,  0,  0,  0,  0,  0,  0,  0,  0,  0,  0,  0,  0,  0,  0,  0,  0,  0,  0,  0,  0,  0,  0,  0,  0,  0,  0]
            ]
        },
        "1": {
            "map": [
                [0,  0,  0,  0,  0,  0,  0,  0,  0,  0,  0,  0,  0,  0,  0,  0,  0,  0,  0,  0,  0,  0,  0,  0,  0,  0,  0,  0,  0,  0,  0],
                [0,  0,  0,  0,  0,  0,  0,  0,  0,  0,  0,  0,  0,  0,  0,  0,  0,  0,  0,  0,  0,  0,  0,  0,  0,  0,  0,  0,  0,  0,  0],
                [0,  0,  0,  0,  0,  0,  0,  0,  0,  0,  0,  0,  0,  0,  0,  0,  0,  0,  0,  0,  0,  0,  0,  0,  0,  0,  0,  0,  0,  0,  0],
                [0,  0,  0,  0,  0,  0,  0,  0,  0,  0,  0,  0,  0,  0,  0,  0,  0,  0,  0, -1,  0,  0,  0,  0,  0,  0,  0,  0,  0,  0,  0],
                [0,  0,  0,  0,  0,  0,  0,  0,  0,  0,  0,  0,  0,  0,  0,  0,  0,  0,  0,  0,  0,  0,  0,  0,  0,  0,  0,  0,  0,  0,  0],
                [0,  0,  0,  0,  0,  0,  0,  0,  0,  0,  0,  0, -2,  0,  0,  0,  0,  0,  0,  0,  0,  0,  0,  0,  0,  0,  0,  0,  0,  0,  0],
                [0,  0,  0,  0,  0,  0,  0,  0,  0,  0,  0, 13, 14, 15,  0,  0,  0,  0,  0,  0,  0,  0,  0,  0,  0,  0,  0,  0,  0,  0,  0],
                [0,  0,  0,  0,  0,  0,  0,  0,  0,  0,  0,  0,  0,  0,  0,  0,  0,  0,  0,  0,  0,  0,  0,  0,  0,  0,  0,  0,  0,  0,  0],
                [0,  0,  0,  0,  0,  0,  0,  0,  0,  0,  0,  0,  0,  0,  0,  0,  0, 13, 14, 14, 15,  0,  0,  0,  0,  0,  0,  0,  0,  0,  0],
                [0,  0,  0,  0,  0,  0, -2, -2, -2,  0,  0,  0,  0, -2,  0,  0,  0,  0,  0,  0,  0,  0,  0,  0, -2, -2,  0,  0,  0,  0,  0],
                [0,  0,  0,  0,  0,  0,  1,  2,  3,  0,  0,  0,  0,  4,  0,  0,  0,  0,  0,  0,  0,  0,  0,  1,  2,  2,  3,  0,  0,  0,  0],
                [0,  0,  0,  0,  0,  0,  5,  6,  7,  0,  0,  0,  0,  8,  0,  0,  0,  0,  0,  0,  0,  0,  0,  5,  6,  6,  7,  0,  0,  0,  0],
                [0,  0,  0,  0,  0,  0,  5,  6,  7,  0,  0,  0,  0,  8,  0,  0,  0, -2,  0,  0,  0,  0,  0,  5,  6,  6,  7,  0,  0,  0,  0],
                [0,  0,  0, -2,  0,  0,  5,  6,  7,  0,  0,  0,  0, 12,  0,  0, 13, 14, 14, 15,  0,  0,  0,  9, 10, 10, 11,  0,  0,  0,  0],
                [0,  0,  0,  4,  0,  0,  5,  6,  7, -2, -2, -2,  0,  0,  0,  0,  0,  0,  0,  0,  0,  0,  0,  0,  0,  0,  0,  0,  0,  0,  0],
                [0,  0,  0,  8,  0,  0,  5,  6, 17,  2,  2,  3,  0,  0,  0,  0,  0,  0,  0,  0,  0,  0,  0,  0,  0,  0,  0,  0,  0,  0,  0],
                [0,  0,  0,  8,  0,  0,  9, 10, 10, 10, 10, 11,  0,  0,  0,  0,  0,  0,  0,  0,  0,  0,  0,  0,  0,  0,  0,  0,  0,  0,  0],
                [0,  0,  0,  8,  0,  0,  0,  0,  0,  0,  0,  0,  0,  0,  0,  0,  0,  0,  0,  0,  0,  0,  0,  0,  0,  0,  0,  0,  0,  0,  0],
                [0,  0,  0,  8,  0,  0,  0,  0,  0,  0,  0,  0,  0,  0,  0, -2,  0, -2,  0,  0,  0,  0,  0,  0,  0,  0,  0,  0,  0,  0,  0],
                [0,  0,  0, 12,  0,  0,  0,  0,  0,  4,  0,  0,  0,  0, 13, 14, 14, 14, 15,  0,  0,  0,  0,  0,  0,  0,  0,  0,  0,  0,  0],
                [0,  0,  0,  0,  0, -2, -2,  0,  0,  8,  0,  0,  0,  0,  0,  0,  0,  0,  0,  0,  0,  0,  0,  0,  0,  0,  0,  0,  0,  0,  0],
                [0,  0,  0,  0,  0, 13, 15,  0,  0,  8,  0,  0,  0,  0,  0,  0,  0,  0,  0,  0,  0,  0,  0,  0,  0,  0,  0,  0,  0,  0,  0],
                [0,  0,  0,  0,  0,  0,  0,  0,  0,  8,  0,  0,  0,  0,  0,  0,  0,  0,  0,  0,  0,  0,  0,  0,  0,  0,  0,  0,  0,  0,  0],
                [0,  0,  0,  0,  0,  0,  0,  0,  0, 12,  0,  0,  0,  0,  0,  0,  0,  0,  0,  0,  0,  0,  0,  0,  0,  0,  0,  0,  0,  0,  0],
                [0,  0,  0,  0,  0,  0,  0,  0,  0,  0,  0,  0,  0,  0,  0,  0,  0,  0,  0,  0,  0,  0,  0,  0,  0,  0,  0,  0,  0,  0,  0],
                [0,  0,  0,  0,  0,  0,  0,  0,  0,  0,  0,  0,  0,  0,  0,  0,  0,  0,  0,  0,  0,  0,  0,  0,  0,  0,  0,  0,  0,  0,  0],
                [0,  0,  0,  0,  0,  0,  0,  0,  0,  0,  0,  0,  0,  0,  0,  0,  0,  0,  0,  0,  0,  0,  0,  0,  0,  0,  0,  0,  0,  0,  0],
                [0,  0,  0,  0,  0,  0,  0,  0,  0,  0,  0,  0,  0,  0,  0,  0,  0,  0,  0,  0,  0,  0,  0,  0,  0,  0,  0,  0,  0,  0,  0],
                [0,  0,  0,  0,  0,  0,  0,  0,  0,  0,  0,  0,  0,  0,  0,  0,  0,  0,  0,  0,  0,  0,  0,  0,  0,  0,  0,  0,  0,  0,  0],
                [0,  0,  0,  0,  0,  0,  0,  0,  0,  0,  0,  0,  0,  0,  0,  0,  0,  0,  0,  0,  0,  0,  0,  0,  0,  0,  0,  0,  0,  0,  0],
                [0,  0,  0,  0,  0,  0,  0,  0,  0,  0,  0,  0,  0,  0,  0,  0,  0,  0,  0,  0,  0,  0,  0,  0,  0,  0,  0,  0,  0,  0,  0]
            ]
        },
        "2": {
            "map": [
                [0,  0,  0,  0,  0,  0,  0,  0,  0,  0,  0,  0,  0,  0,  0,  0,  0,  0,  0,  0,  0,  0,  0,  0,  0,  0,  0,  0,  0,  0,  0],
                [0,  0,  0,  0,  0,  0,  0,  0,  0,  0,  0,  0,  0,  0,  0,  0,  0,  0,  0,  0,  0,  0,  0,  0,  0,  0,  0,  0,  0,  0,  0],
                [0,  0,  0,  0,  0,  0,  0,  0,  0,  0,  0,  0,  0,  0,  0,  0,  0,  0,  0,  0,  0,  0,  0,  0,  0,  0,  0,  0,  0,  0,  0],
                [0,  0,  0,  0,  0,  0,  0,  0,  0,  0,  0,  0,  0,  0,  0,  0,  0,  0,  0, -1,  0,  0,  0,  0,  0,  0,  0,  0,  0,  0,  0],
                [0,  0,  0,  0,  0,  0,  0,  0,  0,  0,  0,  0,  0,  0,  0,  0,  0,  0,  0,  0,  0,  0,  0,  0,  0,  0,  0,  0,  0,  0,  0],
                [0,  0,  0,  0,  0,  0,  0,  0,  0,  0,  0,  0, -2,  0,  0,  0,  0,  0,  0,  0,  0,  0,  0,  0,  0,  0,  0,  0,  0,  0,  0],
                [0,  0,  0,  0,  0,  0,  0,  0,  0,  0,  0, 13, 14, 15,  0,  0,  0,  0,  0,  0,  0,  0,  0,  0,  0,  0,  0,  0,  0,  0,  0],
                [0,  0,  0,  0,  0,  0,  0,  0,  0,  0,  0,  0,  0,  0,  0,  0,  0,  0,  0,  0,  0,  0,  0,  0,  0,  0,  0,  0,  0,  0,  0],
                [0,  0,  0,  0,  0,  0,  0,  0,  0,  0,  0,  0,  0,  0,  0,  0,  0, 13, 14, 14, 15,  0,  0,  0,  0,  0,  0,  0,  0,  0,  0],
                [0,  0,  0,  0,  0,  0, -2, -2, -2,  0,  0,  0,  0, -2,  0,  0,  0,  0,  0,  0,  0,  0,  0,  0, -2, -2,  0,  0,  0,  0,  0],
                [0,  0,  0,  0,  0,  0,  1,  2,  3,  0,  0,  0,  0,  4,  0,  0,  0,  0,  0,  0,  0,  0,  0,  1,  2,  2,  3,  0,  0,  0,  0],
                [0,  0,  0,  0,  0,  0,  5,  6,  7,  0,  0,  0,  0,  8,  0,  0,  0,  0,  0,  0,  0,  0,  0,  5,  6,  6,  7,  0,  0,  0,  0],
                [0,  0,  0,  0,  0,  0,  5,  6,  7,  0,  0,  0,  0,  8,  0,  0,  0, -2, -2,  0,  0,  0,  0,  5,  6,  6,  7,  0,  0,  0,  0],
                [0,  0,  0, -2, -2, -2,  5,  6,  7,  0,  0,  0,  0, 12,  0,  0,  1,  2,  2,  3,  0,  0,  0,  9, 10, 10, 11,  0,  0,  0,  0],
                [0,  0,  0,  1,  2,  2, 16,  6,  7, -2, -2, -2,  0,  0,  0,  0,  5,  6,  6,  7,  0,  0,  0,  0,  0,  0,  0,  0,  0,  0,  0],
                [0,  0,  0,  5,  6,  6,  6,  6, 17,  2,  2,  3,  0,  0,  0,  0,  5,  6, 19, 11,  0,  0,  0,  0,  0,  0,  0,  0,  0,  0,  0],
                [0,  0,  0,  5,  6,  6, 19, 10, 10, 10, 10, 11,  0,  0,  0,  0,  9, 10, 11,  0,  0,  0,  0,  0,  0,  0,  0,  0,  0,  0,  0],
                [0,  0,  0,  5,  6,  6,  7,  0,  0,  0,  0,  0,  0,  0,  0,  0,  0,  0,  0,  0,  0,  0,  0,  0,  0,  0,  0,  0,  0,  0,  0],
                [0,  0,  0,  5,  6,  6,  7,  0,  0, -2,  0,  0,  0,  0,  0, -2,  0, -2,  0,  0,  0,  0,  0,  0,  0,  0,  0,  0,  0,  0,  0],
                [0,  0,  0,  9, 10, 10, 11,  0,  0,  4,  0,  0,  0,  0, 13, 14, 14, 14, 15,  0,  0,  0,  0,  0,  0,  0,  0,  0,  0,  0,  0],
                [0,  0, -2,  0,  0,  0,  0,  0,  0,  8,  0,  0,  0,  0,  0,  0,  0,  0,  0,  0,  0,  0,  0,  0,  0,  0,  0,  0,  0,  0,  0],
                [0,  0,  4,  0,  0,  0,  0,  0,  0,  8,  0,  0,  0,  0,  0,  0,  0,  0,  0,  0,  0,  0,  0,  0,  0,  0,  0,  0,  0,  0,  0],
                [0,  0,  8,  0,  0,  0, -2,  0,  0,  8,  0,  0,  0,  0,  0,  0,  0,  0,  0,  0,  0,  0,  0,  0,  0,  0,  0,  0,  0,  0,  0],
                [0,  0,  8,  0,  0,  0,  4,  0,  0, 12,  0,  0,  0,  0,  0,  0,  0,  0,  0,  0,  0,  0,  0,  0,  0,  0,  0,  0,  0,  0,  0],
                [0,  0, 12,  0,  0,  0,  8,  0,  0,  0,  0,  0,  0,  0,  0,  0,  0,  0,  0,  0,  0,  0,  0,  0,  0,  0,  0,  0,  0,  0,  0],
                [0,  0,  0,  0,  0,  0,  8,  0,  0,  0,  0,  0,  0,  0,  0,  0,  0,  0,  0,  0,  0,  0,  0,  0,  0,  0,  0,  0,  0,  0,  0],
                [0,  0,  0,  0,  0,  0,  8,  0,  0,  0,  0,  0,  0,  0,  0,  0,  0,  0,  0,  0,  0,  0,  0,  0,  0,  0,  0,  0,  0,  0,  0],
                [0,  0,  0,  0,  0,  0, 12,  0,  0,  0,  0,  0,  0,  0,  0,  0,  0,  0,  0,  0,  0,  0,  0,  0,  0,  0,  0,  0,  0,  0,  0],
                [0,  0,  0,  0,  0,  0,  0,  0,  0,  0,  0,  0,  0,  0,  0,  0,  0,  0,  0,  0,  0,  0,  0,  0,  0,  0,  0,  0,  0,  0,  0],
                [0,  0,  0,  0,  0,  0,  0,  0,  0,  0,  0,  0,  0,  0,  0,  0,  0,  0,  0,  0,  0,  0,  0,  0,  0,  0,  0,  0,  0,  0,  0],
                [0,  0,  0,  0,  0,  0,  0,  0,  0,  0,  0,  0,  0,  0,  0,  0,  0,  0,  0,  0,  0,  0,  0,  0,  0,  0,  0,  0,  0,  0,  0]
            ]
        }
    }
}